┏-━-━-━-━-━-━-━-━-━-┓
|                   |
┃ ┏-    ┏-━-━-      ┃
| |   | |       | | |
┃-━-  ┃ ┃-      ┃-┛ ┃
|     | |   | | |   |
┃ ┏-  ┃-┛ ┏-┛ ┃-━-  ┃
| |   |   |   |     |
┃-━-  ┃   ┃   ┃ ┏-  ┃
|     | | | | | |   |
┗-━-━-━-━-━-━-━-━-━-┛
