+-+-+-+-+-+-+-+-+-+-+
|                   |
+ +-+ + +-+-+-+ + + +
| |   | |       | | |
+-+-+ + +-+ + + +-+ +
|     | |   | | |   |
+ +-+ +-+ +-+ +-+-+ +
| |   |   |   |     |
+-+-+ + + + + + +-+ +
|     | | | | | |   |
+-+-+-+-+-+-+-+-+-+-+
