┏━━━━━━━━━━━━━━━━━━━┓
┃                   ┃
┣━╸ ┏━╸ ┏━╸ ┏━╸ ╻ ╻ ┃
┃   ┃   ┃   ┃   ┃ ┃ ┃
┃ ╻ ┣━╸ ┣━━━┻━━━┻━┛ ┃
┃ ┃ ┃   ┃           ┃
┣━┻━┛ ╻ ┃ ╻ ╻ ┏━━━╸ ┃
┃     ┃ ┃ ┃ ┃ ┃     ┃
┣━━━╸ ┃ ┃ ┣━┻━┛ ┏━╸ ┃
┃     ┃ ┃ ┃     ┃   ┃
┗━━━━━┻━┻━┻━━━━━┻━━━┛
