┏━━━━━━━━━━━━━━━━━━━┓
┃                   ┃
┃ ┏━━ ┃ ┏━━━━━━ ┃ ┃ ┃
┃ ┃   ┃ ┃       ┃ ┃ ┃
┣━┻━━ ┃ ┣━━ ┃ ┃ ┣━┛ ┃
┃     ┃ ┃   ┃ ┃ ┃   ┃
┃ ┏━━ ┣━┛ ┏━┛ ┣━┻━━ ┃
┃ ┃   ┃   ┃   ┃     ┃
┣━┻━━ ┃ ┃ ┃ ┃ ┃ ┏━━ ┃
┃     ┃ ┃ ┃ ┃ ┃ ┃   ┃
┗━━━━━┻━┻━┻━┻━┻━┻━━━┛
