┏━━━━━━━━━━━━━━━━━━━┓
┃                   ┃
┣━━━╸ ┏━━━━━╸ ┏━━━╸ ┃
┃     ┃       ┃     ┃
┣━━━━━┻━╸ ╻ ╻ ┣━━━╸ ┃
┃         ┃ ┃ ┃     ┃
┃ ┏━━━━━╸ ┣━┛ ┣━━━╸ ┃
┃ ┃       ┃   ┃     ┃
┃ ┣━╸ ┏━━━┛ ┏━┻━━━╸ ┃
┃ ┃   ┃     ┃       ┃
┗━┻━━━┻━━━━━┻━━━━━━━┛
